;

#####################
#@    $$  $$ $ $ $ $#
#####$$ $$   #$ $ $ #
# $ $#  $ $  # $ $  #
#  $  #   $  #  $ $ #
#  #   #      #  $ $#
#  #$$ #   &   #$ $ #
###   $# $    $ #####
# $ $   $  #  #$$  @#
#$ $ $   $ # $ #$   #
# $ $     # $   #$  #
##   $$## $  $   ####
# ### $$ $  ### $$  #
#@      $$  #    $$ #
#####################

;

#####################
######    #  @ ######
###### $ $#$ $ ######
######$ $ # $ $######
##    @ $$#$$  $   ##
# $#  $$$$#$$$$  #$ #
# ## $ $$ * $$ $ ## #
# ####### & ####### #
# ## $ $$   $$ $ ## #
# $   $$$$#$$$$   $ #
#$$# $  $$#$$  $ #$$#
##$$$#$ $ # $ $#$$$##
###### $ $#$ $ ######
######       @ ######
#####################

;

#####################
##@  $     $       ##
##      $     # #  ##
###########$ # # # ##
##     #  $$       ##
##   #    ###########
##      $$ $$   #  ##
##$$$$$$# & #$$$$$$##
##  #   $$ $$     @##
###########    #   ##
##       $$  #     ##
## # # # $###########
##  # #     $      ##
##@      $     $   ##
#####################